7 13
3
S.........S..
E..M.........
.............
E..M.........
...........M.
.............
.............
Easy
---
....E.......S
E..M......E..
......E......
E..M.....E...
...........S.
.............
.............
Medium
---
.S....S.....S
E..M......E..
......E......
E..M.....E...
......E....S.
.............
.............
Hard
